13111111
15555221
12225221
12255221
12252221
12252221
15555541
11111111
length=17
time=36
