1311111111111111111111111
1515551555551555555555121
1515151111151511151115121
1515155555155522155515121
1515111115111111111515121
1515155515155515551515121
1515151515151515151515121
1515151555151515151515551
1515151111151515151511151
1515155512251555155512151
1515111511151111111112151
1515551555155555155555151
1512151115111115151115151
1512151225155555151215151
1512151115151111151215151
1512155515151222155515151
1512111515151211111515151
1512155515151215555515151
1511151115151215111115151
1555151215151555122215151
1115151215151511121215151
1215151215151512221215151
1215151215151512121115151
1215551555151512122215151
1211111511151511111215151
1555221555151555555515151
1515111115151111111515151
1515155515155515551515151
1515151515111515151515151
1515551555155515151515551
1511111111151115151511111
1555551555151515155512221
1111151515151515111112121
1555551515551555122222121
1511111511111511121111121
1555121555121555121222221
1115121215121115121111121
1215121215122555122222121
1215121215111511121112121
1555121215551512121222121
1511121211151512121211111
1512222215551512121212221
1512111115111512121212121
1512155555155512221222121
1512151111151112111111121
1512155512155512222222121
1511111512111511111112121
1515555512221555122212121
1515111111121115121211121
1515551222122215121222221
1511151212121215121111121
1555151212121215121222121
1115151212121215121212121
1555151212221215121212121
1511151211111115121212111
1515551555155555122212221
1515111515151111111111121
1515121515551225555515551
1515121511111115111515151
1515121515555515121555151
1515121515111515121111151
1515155515551515122222151
1515151111151515121212151
1515151225551515121212151
1515151215111515121212151
1515151215121515121212151
1515151115121515121211151
1555155555122555121222251
1111111111111111111111141
length=574
time=97872
