13111111
15222221
15222221
15555551
15222251
15522251
15555541
11111111
length=27
time=101
